6666666644666666666644666666666-
1111111144111111111144111111111-
1111111144111111111144111111111-
1111111144111111111144111111111-
1111444444111111111144111111111-
1111444444111111111144111111111-
1111441111111111111144111111111-
1111441111111111111144111111111-
1111441111111111144444111111111-
1111444444441111144444111111111-
1111444444441111144111111111111-
1111111111441111144111111111111-
1111111111441111144111111111111-
1111111111444444444111111111111-
1111111111444444444111111111111-
1111111111441111111111111111111-
1111111111441111111111111111111-
1111111111441111111111111111111-
1111111111441111111111111111111-
1111111111441111111111111111111-
1111111111441111111111111111111-
6666666666446666666666666666666