6666666644666666666644666666666-
1111111744711111111144111111111-
1111111744711111111144111111111-
1117777744711111111144111111111-
1117444444711111111144111111111-
1117444444711111111144111111111-
1117447777711111111144111111111-
1117447111111111111144111111111-
1117447777777111144444111111111-
1117444444447111144444111111111-
1117444444447111141111111111111-
1117777777447111144111111111111-
1111111117447111144111111111111-
1111111117444444444111111111111-
1111111117444444441111111111111-
1111111117447777711111111111111-
1111111117447111111111111111111-
1111111117447111111111111111111-
1111111117447111111111111111111-
1111111117447111111111111111111-
1111111117447111111111111111111-
6666666666446666666666666666666